################################################################
#..............................................................#
#........................................................#######
#...................................................#####......#
#..............................................#####...........#
#.........................................#####................#
#....................................#####.....................#
#........................######.#####..........................#
#.....................###......................................#
#..............###.###.........................................#
#...........###................................................#
#........###...................................................#
#....####......................................................#
###............................................................#
#..#...........................................................#
############.############......................................#
#..........................##########..........................#
#......................................########................#
#..........................#..........#####......#........S....#
################################################################
